 !####!#####!
 !..  !     !#!
 !..  ! $  $  !
 !..  !$###!  !
 !..    @ #!  !
 !..  ! !  $ #!
 !#!##! !#$ $ !
   ! $  $ $ $ !
   !    !     !
   !####!#####!
; 1

; 2