 ############
 #..  #     ###
 #..  # $  $  #
 #..  #$####  #
 #..    @ ##  #
 #..  # #  $ ##
 ###### ##$ $ #
   # $  $ $ $ #
   #    #     #
   ############
; 1

    #####
    #   #
    #$  #
  ###  $##
  #  $ $ #
### # ## #   ######
#   # ## #####  ..#
# $  $          ..#
##### ### #@##  ..#
    #     #########
    #######
; 2