 !####!#####!
 !..  !     ##!
 !..  ! $  $  !
 !..  !$###!  !
 !..    @ #!  !
 !..  ! !  $ #!
 ##!### ##$ $ !
   ! $  $ $ $ !
   !    !     !
   ############
; 1

; 2